#######
#######
# #####
# #####
# #####
# #####
# #####
#     #
# #####
#######
